#domain
hospital
#levelname
MADS
#colors
red: 1,A
blue: 0,B
pink: 2,C
#initial
++++++++++++
+ 1   ++++++
+0    ++++++
+     ++++++
+    B++++++
+   A ++++++
+++++ ++++++
+        2 +
+          +
++++++     +
+  C       +
++++++++++++
#goal
++++++++++++
+     ++++++
+     ++++++
+     ++++++
+     ++++++
+     ++++++
+++++ ++++++
+B         +
+          +
++++++     +
+A  C      +
++++++++++++
#end
