#domain
hospital
#levelname
MAybetwo
#colors
red:   0, A
green: 1, B
blue:  2, C
#initial
+++++++++++++
+0       A  +
+   +++++   +
+   +   +   +
+ B +   + C +
+   +   +   +
+   +++++   +
+2        1 +
+++++++++++++
#goal
+++++++++++++
+           +
+   +++++   +
+ B +   + A +
+   +   +   +
+   +   + C +
+   +++++   +
+           +
+++++++++++++
#end
